T,T,T,T,T,T,T,T,T,T
B, , , ,T,T, , , ,T
T, ,T, , , , ,T, ,T
T, ,T,T,T,T, ,T, ,T
T, ,T, , , , ,T,T,T
T, ,T, ,T, , , , ,T
T, ,T, ,T,T,T,T,T,T
T, ,T, , , , , , ,T
T, ,T,T,T,T, ,T, ,T
T, , ,T, ,T,X,T,T,T