111111111111111111111111
1P000C00000000000000E001
111111111111111111111111